1111111111111
100100C0000C1
1000011111001
1P0011000E001
1000011100001
1111000110001
10N0C11111111
1111111111111
