1111111111111111111
1000000000000000001
1C01111111111111001
1P0000000000000C001
1111101111011100001
1000001000000100001
1000001000000100001
10000010000N0100001
1000001111111100001
10N0000000000000001
100N01111111111E001
1111111111111111111