1111111111111
100100C0000C1
1000011111001
10001100PE001
1N00011100001
1111000110N01
1C00011111111
1111111111111