1111111111111111111111111111111111
1P00000000000N000000000000000000E1
1111101111111111111111111111011111
1C00000000000000000000000000000C01
1C01111111111111111111111111000111
1C01000000000000000000000001000111
1C01111111111111111110111111000111
1C000000000C0N0000000C000000000001
1111101111011111111111011111111111
1C00000000100000000001000000000C01
1C01111111111111111111111111100111
1C01000000000000000000000001000111
1C01111111111111111110111111000111
1C00000000000N0000000C000000000001
1111111111111111111111111111111111