1111111111111111111111111111111111111111111111111111
10000000000000010000000000000000000000000000P0000001
1011111111111101011111111111111111111111111111111101
1010000000000101000000000C00000000000000000000000101
1010111111100111011111111111111111111111111110110101
10000E0000000101000000000000000000000000000000000001
1011111111110101011111111111111111111111111111110101
1010000000000101000000000000000000000000000000000101
1011111111110111011111111111111111111111111111110101
1000000000000000000000000000000000000000000000000001
1011100111111111011111111111111111111111111110110101
1010000000000001000000000000000000000000000000000101
1011111111111101011111111111111111111111111111111101
1000000000000001000000000000000000000000000000000001
1011111111110101011111111111111111111111111111110101
1010000000000101000000000000000000000000000000000101
1011111111110111011111111111111111111111111111110101
1000000000000001000000000000000000000000000000000001
1010000000000101000000000000000000000000000000000101
1011111111110101011111111111111111111111111111110101
1000000000000001000000000000000000000000000000000001
1111111111111111111111111111111111111111111111111111
