1111111111111
10000C00000C1
1010010111111
1P1011E000001
1111111111111