1111111111111
11C10000000C1
11E1111110111
1P00000000011
1111111111111